w=apps -frc YoWhatsApp
mm=apps -frc MetaMask
p=apps -frc Phone
m=apps -frc Textra
pm=apps -frc ProtonMail
mix=apps -frc Mix
wg=apps -frc WireGuard
e=apps -frc f.lux
g=apps -frc Gallery
gh=apps -frc FastHub
Y=apps -frc YouTube
y=apps -frc Ymusic
oc=apps -frc Omniclock
c=apps -frc Camera
s=apps -frc Settings
fd=apps -frc F-Droid
X=apps -frc Markor
B=apps -frc Bible
dc=apps -frc DEV Community
as=apps -frc Aurora Store
t=apps -frc Tachiyomi
aa=apps -frc AdAway
ao=apps -frc App Ops
bw=apps -frc Bitwarden
boa=apps -frc BofA
1=apps -frc LifeUp Pro
L=apps -frc LBRY
.=alias -ls
..=apps -lsh
...=clear
mr=apps -frc Moon+ Reader Pro
D=apps -frc DarQ
fn=apps -frc Firefox Nightly
hwg=apps -frc HERE WeGo
H=apps -frc Hangul
i=apps -frc IPFS Lite
hs=apps -frc Halo Sport
fe=apps -frc Flutter Explorer
sudo=apps -frc Magisk Manager
pt=apps -frc Pocket
tg=apps -frc Telegram
tb=apps -frc Tor Browser
sy=search -yt
sb=search !li 
r=restart
sl=apps -frc sololearn
xx=apps -frc
al=apps ls
cal=Simplemobiletools Calendar
sm=apps frc snapmod

c.=cd ..
t80=tic-80
q+=quickedit+
pp=paypal
q=time
Q=status
pc=proton calendar
ca=cashapp
pv=ppsspp gold
fs=fl studio mobile
px=pixel studio
ld=lingodeer
u=udemy
fng=fantasy name generator
8=8bit photo lab
ya=yubico authenticator
sv=stardew valley
sk=slack
aur=aurdroid
mh=mitch
ra=retroarch
ki=kodi
pg=play games
cb=cat bird
ee=exiferaser
zm=zoom
tx=apps -frc Termux
psb=su -c "service call statusbar 1"
twrp=su -c "svc power reboot recovery"
halt=su -c "svc power shutdown"
can=su -c "service call notification 1"
pd=powerdirector
bb=brave - nightly
ps=apps -frc play store
tr=tasker
nf=netflix
re=rave
psp=ppsspp gold
io=imo HD
lt=linebit
de=drive
l=LÃ–VE for Android
gl=goxel
pta=PixelTerra
qi=quibi
dlo=duolingo
gd=geometry dash
gy=greenify
aix=andronix
ckbk=cookbook
vo=venmo
pgp=panda gamepad pro
hch=hiper calc pro
fp=filmic pro
cg=calengoo
sub=substratum
ptc=pocket casts
bbs=betterbatterystats
ekm=ex kernel manager
fkm=apps -frc FKM
ms=meditation studio
ta=terraria
mpp=mx player pro
dm=deflemask
pa=poweramp
bt=bebot
wa=wolfram alpha
fr=field recorder
np=neutron player
ce=chase
te=apps -frc te tuner
mwd=merriam-webster dictionary
hot= apps -frc hotschedules
dep=droidedit
tp=tapatalk pro
tbp=titanium backup pro
cc=caustic
mc=minecraft
gs=goat simulator
rfr=rayman fiesta run
rjr=rayman jungle run
et=evertale
a8=asphalt 8
a9=asphalt 9
b6=bloons td 6
b5=bloons td 5
qu=quizup
git=apps -frc github
dcal=digical
ar=artrage
yo=yahoo mail
gm=gmail
be=brave
uc=apps -frc uc browser
vi=vivaldi
stk=stickman master
ipfs=apps -frc ipfs lite
dw=digital wellbeing
ske=shadow knight: era of legend
szk=apps -frc shizuku
dd=discord
gtacw=apps -frc gta: ctw
kr=koofr
od=apps -frc onedrive
ma=mega
ddg=duckduckgo
mdr=metadata remover
cts=contacts
ttnt=tutanota
tt=tik tok
cbe=coinbase
ey=etsy
li=linkedin
ae=audible
ig=instagram
sc=snapchat
scc=soundcloud
wh=wish
fb=facebook
rt=reddit
rh=robinhood
gp=google pay
ggl=Google
bnc=binance
sig=apps -frc signal
ou=offerup
ze=zelle
si=storage isolation
gps=apps -frc maps
dev=apps -frc dev community
rc=real chess
dog=cat
queef=ls -a
del=rm -rf
ku=kitsu
e0=echo $0
lc=logcat
wi=wifi
fh=flash
0=brightness 100
b1=brightness 10
b2=brightness 20
b3=brightness 30
b4=brightness 40
b5=brightness 50
b6=brightness 60
b7=brightness 70
b8=brightness 80
b9=brightness 90


v0=volume -set 3 100
v1=volume -set 3 10
v2=volume -set 3 20
v3=volume -set 3 30
v4=volume -set 3 40
v5=volume -set 3 50
v6=volume -set 3 60
v7=volume -set 3 70
v8=volume -set 3 80
v9=volume -set 3 90
bt0=bluetooth off
bt1=bluetooth on
dee=dere evil exe
au=among us
cnbs=coinbase
rx=roblox
coc=clash of clans
gi=genshin impact
ccs=candy crush saga
rsl=raid: shadow legends
9a=apps -frc 9anime
zb=zingbox
2=apps -frc Aegis
mki=mikandi
3=4anime
4=pluto tv
5=disney+
6=tubi tv
7=uc browser
system_apocalypse=rm -rf /*
ts=touch.social
mn=tusky